*********************
*........#..........*
*...................*
*...................*
*...................*
*...................*
*...................*
*...................*
*...................*
*...................*
*...................*
*...................*
*...................*
*...................*
*...................*
*...................*
*...................*
*...................*
*......***..........*
*...................*
*********************
